10 10
.f........
...f..f...
......b...
..........
....b...a.
.......f..
..........
........h.
..........
s.........
